%%%%%%%%
%P%%  .%
% %% %%%
%      %
%%% % %%
%%%%%%%%