%%%%%%%
%    P%
% %%% %
%  %  %
%%%% %%
%.   %%
%%%%%%%
